000011110000
000222222000
003333333300
044444444440
555555555555
