011111111110
022222222220
033333333330
044444444440
055555555550